00000000000111111
08087855555878181
00007757775771111
08787855555878781
07777755755777771
08787857575878781
07868675457686871
07676753735767671
07868675457686871
08787857575878781
07777755755777771
08787855555878781
00007757775771111
08087855555878181
00000000000111111
