00000000000000000
00030000000003000
00023333333332000
03221211111212230
00312112221121300
00321211111212300
00311112221111300
00312112421121300
00311112221111300
00321211111212300
00312112221121300
03221211111212230
00023333333332000
00030000000003000
00000000000000000
